11111111111111111111111111111
10010101010101E10101010101001
10000C000000000000000C0000001
10101010101010101010101010101
10000000C000000000000000C0001
10010101010101010101010101001
100000000000000000000C0000001
101010101010101C1010101010101
1000C000000000000000000000001
10010101010101010101010101001
100000000000000000000C0000001
10101010101010101010101010101
100000C0000000000000000000001
10010101010101010101010101001
100C0000000000P0000000000C001
11111111111111111111111111111
