111111111111111111111
101E010000C0000000011
100001111001000110001
101000000000011111001
10C00111100000000C001
100000000000000000001
100111C11110001010001
100000000000000000001
10000000C000000100001
101001111111100001001
1000000C0000000000001
100011000000111111001
10000000000000C000001
101011111100000000001
1000C0000000000000P01
111111111111111111111
