11111111111
1011110E011
10C000000C1
10101110001
10000000001
1101C100001
10000000001
10100010001
100101C0101
1P0000000C1
11111111111
