11111111111
1001010E001
10C000000C1
10101010001
10X00000001
1101C100X01
100X0000001
10100010001
100101C0101
1P0000000C1
11111111111
