1111111111
1010111C01
100E00X001
1000000001
1C11001111
100X0000C1
1111010101
1100010001
1C01000P01
1111111111