11111111111111
101E111C101001
10000000000001
10100111000101
10C0000C000001
10111100010111
1000C000000001
10000011011001
1001100C000001
11100000101001
10P00000000001
11111111111111
