1111111
100E001
1010101
1000C01
1010101
100P001
1111111