1111111111
1010111C01
100E000001
1000000001
1C11001111
10000000C1
1111000101
1100010001
1C01000P01
1111111111