11111111111111
101E111C101001
1000000000X001
10100111000101
10C0000C000001
10111100010111
100XC000000001
10000011011001
1001100C000001
11100000101001
10P0000000X001
11111111111111
