111111111111111111111111111111111111111111111111
100000110000011111000001111100000110000011000001
100000000000000000000000000000000001111111100111
100000000000000000000000000000000000000000000001
100000000000000000000001111110000000000000000001
100000000000000000000000000000000000000000000001
111110000000000000000000000000000000000111111111
100000000000111111110000000000000000000000000001
100000000000000000000000000000000000010000000001
100000000000000000000000000000000000010000000001
111110000000000000000000000000000000010000000011
100000000000000000000001111111000000010000000001
100000000000000000000000000000000000010000000001
100000000000000000000000000000000010000000000001
111111111111111111111111111111111111111111111111
