1111111111111111
100vnfoa;nkobfa1
111PPPEEEXXXCCC1
1111111111111111