1111111111
1000000001
100E000111
1P000001C1
1111111111
