1111111111
1000000001
100C000111
1P000001E1
1111111111
