1111111111111111111111111111111
1CP000000000000000000E000011111
1111111111111111111111111111111
