1111111
100E1
1C1P111
1111111
